ID	Mutation
C_A.ACA	A[C>A]A
C_A.ACC	A[C>A]C
C_A.ACG	A[C>A]G
C_A.ACT	A[C>A]T
C_A.CCA	C[C>A]A
C_A.CCC	C[C>A]C
C_A.CCG	C[C>A]G
C_A.CCT	C[C>A]T
C_A.GCA	G[C>A]A
C_A.GCC	G[C>A]C
C_A.GCG	G[C>A]G
C_A.GCT	G[C>A]T
C_A.TCA	T[C>A]A
C_A.TCC	T[C>A]C
C_A.TCG	T[C>A]G
C_A.TCT	T[C>A]T
C_G.ACA	A[C>G]A
C_G.ACC	A[C>G]C
C_G.ACG	A[C>G]G
C_G.ACT	A[C>G]T
C_G.CCA	C[C>G]A
C_G.CCC	C[C>G]C
C_G.CCG	C[C>G]G
C_G.CCT	C[C>G]T
C_G.GCA	G[C>G]A
C_G.GCC	G[C>G]C
C_G.GCG	G[C>G]G
C_G.GCT	G[C>G]T
C_G.TCA	T[C>G]A
C_G.TCC	T[C>G]C
C_G.TCG	T[C>G]G
C_G.TCT	T[C>G]T
C_T.ACA	A[C>T]A
C_T.ACC	A[C>T]C
C_T.ACG	A[C>T]G
C_T.ACT	A[C>T]T
C_T.CCA	C[C>T]A
C_T.CCC	C[C>T]C
C_T.CCG	C[C>T]G
C_T.CCT	C[C>T]T
C_T.GCA	G[C>T]A
C_T.GCC	G[C>T]C
C_T.GCG	G[C>T]G
C_T.GCT	G[C>T]T
C_T.TCA	T[C>T]A
C_T.TCC	T[C>T]C
C_T.TCG	T[C>T]G
C_T.TCT	T[C>T]T
T_A.ATA	A[T>A]A
T_A.ATC	A[T>A]C
T_A.ATG	A[T>A]G
T_A.ATT	A[T>A]T
T_A.CTA	C[T>A]A
T_A.CTC	C[T>A]C
T_A.CTG	C[T>A]G
T_A.CTT	C[T>A]T
T_A.GTA	G[T>A]A
T_A.GTC	G[T>A]C
T_A.GTG	G[T>A]G
T_A.GTT	G[T>A]T
T_A.TTA	T[T>A]A
T_A.TTC	T[T>A]C
T_A.TTG	T[T>A]G
T_A.TTT	T[T>A]T
T_C.ATA	A[T>C]A
T_C.ATC	A[T>C]C
T_C.ATG	A[T>C]G
T_C.ATT	A[T>C]T
T_C.CTA	C[T>C]A
T_C.CTC	C[T>C]C
T_C.CTG	C[T>C]G
T_C.CTT	C[T>C]T
T_C.GTA	G[T>C]A
T_C.GTC	G[T>C]C
T_C.GTG	G[T>C]G
T_C.GTT	G[T>C]T
T_C.TTA	T[T>C]A
T_C.TTC	T[T>C]C
T_C.TTG	T[T>C]G
T_C.TTT	T[T>C]T
T_G.ATA	A[T>G]A
T_G.ATC	A[T>G]C
T_G.ATG	A[T>G]G
T_G.ATT	A[T>G]T
T_G.CTA	C[T>G]A
T_G.CTC	C[T>G]C
T_G.CTG	C[T>G]G
T_G.CTT	C[T>G]T
T_G.GTA	G[T>G]A
T_G.GTC	G[T>G]C
T_G.GTG	G[T>G]G
T_G.GTT	G[T>G]T
T_G.TTA	T[T>G]A
T_G.TTC	T[T>G]C
T_G.TTG	T[T>G]G
T_G.TTT	T[T>G]T
